BACK	B AE K
BACKWARD	B AE K W ER D
BELLY	B EH L IY
DANCE	D AE N S
FLOP	F L AA P
FORWARD	F AO R W ER D
GET	G EH T
GO	G OW
LEAN	L IY N
LEFT	L EH F T
LIMP	L IH M P
MOVE	M UW V
NONE	N AH N
POINT	P OY N T
RESET	R IY S EH T
RIGHT	R AY T
ROTATE	R OW T EY T
SET	S EH T
TILT	T IH L T
TURN	T ER N
TYPE	T AY P
TYPING	T AY P IH NG
UP	AH P
WAVE	W EY V
WALK	W AO K
ZERO	Z IH R OW
